WWWWWWWWWWWWWWWWWWWWWW
W....................W
W.........A...A......W
W...........A....A...W
W............A.A.....W
W...............A....W
W....................W
W....................W
W....................W
W.....A..............W
W......Q.A...........W
W..Q...A.............W
W....Q..Q............W
W....Q...............W
WWWWWWWWWWWWWWWWWWWWWW