ASSSSSSSSSSSSSSSSSSSSD
GHASSSSSSDFGHASSSSSDFG
FGGGGGGGGHASSSSSSSSSDF
SSSSSSSSSSSSSSSDRWWWWW
SDJJJJJJJJJJASSDQFGGGG
DJJJJJJJJJJJASSDQFGGGG
SSSDJJJJJASSSSSDQFGGGG
SSSSDJFGGGGGGGGHQFGGGG
SSSSSDRWWWWEWWWWTFGGGG
SSSSSDQASSSSSSSSSSSSSS
SDZASDQASSSSSSSSSSSSSS
DCASSDQASSDFGGHASSSSSS
JJJJJJQASSSDFGGGGHASSS
SSSSSSDXADXASSSSSSSSSD
WWWWWWWWWWWWWWWWWWWWWW