WWWWWWWWWWWWW
W...........W
W..WW...WW..W
W.....W.....W
W..WW...WW..W
W.....B.....W
WWW..WWW..WWW
W...........W
W...WW......W
W......B....W
W......WWWW.W
W...........W
W.WWW.......W
W..B...WWW..W
W...........W
W......WWWWWW
W......B....W
WWWWW...WW..W
W...........W
WWWWWWWWWWWWW