WWWWWWWWWWWWW
W...........W
WD..........W
WWW...W.....W
W...W...WWW.W
W...........W
WWW.......WWW
W...K.......W
W...WW......W
W.......B...W
W......WWWW.W
W.C.........W
W.WWW.....C.W
W....W..WWW.W
W...........W
W......WWWWWW
W...........W
WWWWW...W...W
W....P......W
WWWWWWWWWWWWW